111111111
100P1C001
10E111111
111111111